no linkedin url found for ERIC | PELUSO | Documentation Research & Review (DRR) Analyst | [u'UBS Wealth Management']
no linkedin url found for Scott | Scott Weingarten | Photographer | [u'Photographer @ Worldwide']
no linkedin url found for Jeff | Santos | Execution Trader | [u'UBS']
no linkedin url found for Charles Kennedy | ???LION??? | Director of Expansion, Talent Acquisition | [u'World Financial Group (WFG)']
no linkedin url found for Yael | Gozin | Global Clininal Submissions Quality Lead, Senior Director | [u'Pfizer']
no linkedin url found for Mauricio | Vilches | Compliance Officer | [u'UBS Global Asset Management']
no linkedin url found for Vivian | McRostie | Senior Partner | [u'Executive Staffing, Inc.']
no linkedin url found for Lizzette | Sanchez | Professional MotorCoach | [u'Walt Disney World']
no linkedin url found for Andrea | Ormeno | Women's Business Center Director | [u'QEDC']
no linkedin url found for Alexandra | Samaras | Branch Service Asssociate | [u'UBS Wealth Management']
no linkedin url found for Alan | Goldstein | President | [u'Avior Executive Search']
no linkedin url found for Davide | Pironti | Business Development Manager | [u'Marvex Capital']
no linkedin url found for Leonid | Krys | Trading floor compliance | [u'OppenheimerFunds']
no linkedin url found for John | Power | Founder / CFO | [u'OTC Mobile Stores']
no linkedin url found for Pierre | Beauport | Assistant Director, Enterprise Risk Management | [u'AIG']
no linkedin url found for Monica | Malone | Executive Director, Financial Institutions Group | [u'Santander Investment Securities Inc']
no linkedin url found for Colin | Cumberbatch | President | [u'Momentum Executive Staffing Solutions, Inc.']
no linkedin url found for Bari | Reiter | Community Service Representative | [u'Home Instead Senior Care']
no linkedin url found for Piotr | Steranka | Senior Business Operations Analyst | [u'E*TRADE Financial Corporation']
no linkedin url found for Patricia | Sullivan | Human Resources Consultant | [u'Guggenheim Partners']
no linkedin url found for Jordan | Steinberg | Executive Director - TMT Investment Banking | [u'Nomura Securities']
no linkedin url found for Martha | Malone | Vice President | [u'Morgan Stanley']
no linkedin url found for Jennifer | Sommer | Securities Specialist | [u'UBS Wealth Management']
no linkedin url found for Saurav | Das | Salesforce Automation Analyst | [u'Adobe Systems']
no linkedin url found for Mayra | Delao | Purchase Agent | [u'Wall Systems Supply']
no linkedin url found for Andrea | Napoli | Realtor | [u'La Rosa Realty']
no linkedin url found for Adeel | Eijaz | Portfolio Manager | [u'UBS Financial Services']
no linkedin url found for Kenny | Reyes | Account Manager | [u'Aerotek']
no linkedin url found for Karen | Hoyos | President/CEO | [u'KAREN HOYOS INTERNATIONAL']
no linkedin url found for Elyse | Tarnofsky Waldinger | Chief Operating Officer | [u'R Squared Capital Management']
no linkedin url found for Nuri | Benturk | Senior Vice President | [u'RBC Wealth Management']
no linkedin url found for Derek | Arnold | Exhibitor Relations Manager | [u'Art Revolution Taipei']
no linkedin url found for Sebastian | Fernandez | Team Lead QA Test Engineer | [u'UBS']
no linkedin url found for Bernadete | Franco | Partner | [u'AQUA Wealth Management']
no linkedin url found for Nancy | Flores | Executive Assistant, to the Head of Corporate & Institutional Clients Americas | [u'UBS AG, UBS Investment Bank']
no linkedin url found for Urs S | Weber | Relationship Manager & Investment Advisor | [u'Cornerstone Capital Inc.']
no linkedin url found for Michael | DiLeo | Vice President | [u'HSBC Private Bank']
no linkedin url found for Melissa | Spezzano | Executive Coordinator | [u'KORN FERRY']
no linkedin url found for Gary | Fluker | Senior Consultant | [u'Citi']
no linkedin url found for Lisa M | Sacramento | AVP Relationship Manager | [u'JP Morgan Chase Bank NA']
no linkedin url found for Francesco | Avanzolini | Ingegnere | [u'']
no linkedin url found for Wooseok | Choi | Director | [u'Art Brunch']
no linkedin url found for Jennifer | Hochberg | Executive Director | [u'Aareal Capital Corporation']
no linkedin url found for Gilles | Vanackere | Directeur G_n_ral adjoint | [u'Syndicat National des Fabricants de Sucre']
no linkedin url found for Steve | Yang | Senior Analyst | [u'Cabot Lodge Securities _ Alternative Investment']
no linkedin url found for Michael | von Borsig, CFAÂ¬ | Vice President/Client Service - Stifel | [u'Stifel Financial Corp.']
no linkedin url found for Lisandro S. | Grullon, Ph.D. | Senior Linux Engineer | [u'FreshDirect']
no linkedin url found for Ana Paula | Pinto-O'Keefe | International Financial Sales Investor Associate | [u'J.P. Morgan']
no linkedin url found for Sandra | Gooden | Senior Accounts Payable Manager | [u'Peter Thomas Roth Clinical Skin Care']
no linkedin url found for dominic | gomez | CEO/MD | [u'']
no linkedin url found for Maria I Hurtado | Urrea | Customer Service | [u'Chase']
no linkedin url found for Elio | Barrera | Financial Services Professional | [u'New York Life Insurance Company']
no linkedin url found for Robert | Kaniuk, CFA | EM Trader Executive Director | [u'Morgan Stanley']
no linkedin url found for Joerg | Guenther | Senior Vice President, Head of Hedge Funds Services and Derivatives Technology | [u'Northern Trust Corporation']
no linkedin url found for Jackie | Arce | Principal | [u'JARCE Enterprises, Inc.']
no linkedin url found for Bari | Goldman | Director, Institutional Equity Sales | [u'Cantor Fitzgerald']
no linkedin url found for Mark | Linnan | Managing Director | [u'PennantPark Investment Advisers']
no linkedin url found for Claudia | Sintigo | Multimedia Producer, TODAY.com | [u'NBC News']
no linkedin url found for Edwin | Pagan, CAMS | Compliance Officer | [u'Standard Chartered Bank']
no linkedin url found for Daniel | Hofmann, CFA | Director | [u'UBS AG']
no linkedin url found for James | Cassidy | Trader/Director | [u'UBS']
no linkedin url found for Daniel | Moreno | Head of Operations / Manager - Infrastructure and Process Improvement | [u'Ellington Management Group']
no linkedin url found for Carroll | Kent | Executive Assistant to Head of U.S. Wealth | [u'TD Wealth Private Client Group']
no linkedin url found for Jeanette | Tringali | Agent Manager | [u'UnitedHealth Group']
no linkedin url found for Richard | Daetwiler | Director Structured Solutions - Structured Products | [u'UBS']
no linkedin url found for Maria | Diaz | Artist Model | [u'National Academy Museum and School of Fine Arts']
no linkedin url found for Lisa | Markowitz | Director | [u'UBS']
no linkedin url found for Marcus | Epprecht | Senior Advisor and Head of New York Office | [u'Parkview']
no linkedin url found for Colette | Fanord, MBA | Compliance Analyst (AML) Financial Intelligence (Consultant) | [u'Morgan Stanley']
no linkedin url found for Eber | DeLao | Assistant Manager | [u'United Nations Bookshop']
no linkedin url found for Paola | Gallego | Wealth Strategy Associate | [u'UBS Financial Svc Inc']
no linkedin url found for Natalia | Bustamante | Vice Pr_sidente externe | [u"Association _tudiante de l'Ecole de sant_ publique de l'UdeM"]
no linkedin url found for Tony | Morel | Product Sales Specialist | [u'UBS Wealth Management International']
no linkedin url found for Kevin | Foote, CFA | Vice President | [u'Morgan Stanley']
no linkedin url found for Al | Pugliesi | Vice President-Operations | [u'Ramius Trading Strategies']
no linkedin url found for Joseph | Scavo | Managing Director - Head of FCC Wholesale Banking | [u'Wells Fargo']
no linkedin url found for Rosa | Anguas | Directora | [u'ART-BCN']
no linkedin url found for Nellie | Pattavina | Associate Director | [u'UBS Financial Services Inc.']
no linkedin url found for David L. | Fryer | Product Specialist | [u'Pinnacle Associates']
no linkedin url found for Alice W | Chan | Client Advisor, Associate Director | [u'UBS Financial Services Inc. UBS Wealth Management']
no linkedin url found for Helna | Astor | Vice President | [u'Morgan Stanley Private Wealth Management']